
###########
# A     @ #
#         #
# ### ## ##
#   B@## ##
#####B## ##
##### B  ##
##  B@## ##
## ##@## ##
##   @   ##
###########
