
###########
#    # A  #
# BB # BC #
# B  # B# #
#    # B  #
# B  #   ##
# B  #    #
# B       #
#  BBB    #
#        @#
###########

##### #####
##       ##
# #     # #
#  #@ @#  #
#  @#@#@  #
    @#@    
#  @#@#@  #
#  #@ @#  #
# #     # #
##       ##
##### #####