
###########
####@ @####
####@  ####
#         #
# ##  ### #
# ##  ### #
# ### ### #
#  BB ### #
####  ### #
#### A    #
###########

