
###########
#         #
#  A  @ @ #
#         #
#         #
#         #
#    C    #
#    #    #
#  B   B  #
#         #
###########

#####B#####
#         #
#    @    #
###########
#    #    #
     #     
#    #    #
#    #    #
#  @ # @  #
#    #    #
###########
