
###########
#         #
##      C #
## ########
#  ########
#        @#
########  #
#         #
# #########
#       A@#
###########

##### #####
#        @#
#         #
#         #
##### #####
  B     B  
##### #####
#         #
#         #
#@        #
##### #####
