
###########
#    BBA@@#
#    ######
#    #    #
#    #    #
#    #    #
#         #
#         #
#         #
#        @#
########### 