
###########
####@B@####
####  @####
#    ##@ @#
# B  #    #
#A ##   B #
#       ###
#        @#
####B B####
####   ####
###########
