
###########
#@@@     B#
#    C   B#
#A       B#
###       #
######### #
##   B    #
###   B   #
#@### B  ##
#       ###
###########

##### #####
#####@#####
#####@#####
###########
###########
       ####
#       ###
#        ##
##      ###
###    ####
##### #####
