
###########
#A  @#   @#
#  B #    #
## ###    #
#         #
#         #
#         #
#         #
#         #
#         #
###########
