
###########
###@  @####
#    ######
#   @#   ##
#  ### # ##
## #   #C##
## #B  #  #
## #B  #  #
##        #
####A  ####
###########

##### #####
##### #####
##### #####
##### #####
##### #####
#####      
#####  ####
###########
###########
###########
###########
