
###########
#@       @#
# ### ### #
# ### ### #
# ###B### #
#   BAC   #
# ###B### #
# ### ### #
# ### ### #
#@       @#
###########

##### #####
###     ###
##       ##
#    #    #
#   ###   #
   ##@##   
#   # #   #
#         #
##       ##
###     ###
##### #####
